35,35
+ + + + + + + + + + + + + + + + + + + + + + + + + + + + + + + + + + +
+ # + # # + # # + # + # + # # + # # + # + # + # # + # # + # + # + # #
+ + + + + + + + + + + + + + + + + + + + + + + + + + + + + + + + + + +
+ # # # # + # # # # + # # # # + # # # # + # # # # + # # # # + # # # #
+ + + + + + + + + + + + + + + + + + + + + + + + + + + + + + + + + + +
+ # + # # + # # + # + # + # # + # # + # + # + # # + # # + # + # + # #
+ + + + + + + + + + + + + + + + + + + + + + + + + + + + + + + + + + +
+ # # # # + # # # # + # # # # + # # # # + # # # # + # # # # + # # # #
+ + + + + + + + + + + + + + + + + + + + + + + + + + + + + + + + + + +
+ # + # # + # # + # + # + # # + # # + # + # + # # + # # + # + # + # #
+ + + + + + + + + + + + + + + + + + + + + + + + + + + + + + + + + + +
+ # # # # + # # # # + # # # # + # # # # + # # # # + # # # # + # # # #
+ + + + + + + + + + + + + + + + + + + + + + + + + + + + + + + + + + +
+ # + # # + # # + # + # + # # + # # + # + # + # # + # # + # + # + # #
+ + + + + + + + + + + + + + + + + + + + + + + + + + + + + + + + + + +
+ # # # # + # # # # + # # # # + # # # # + # # # # + # # # # + # # # #
+ + + + + + + + + + + + + + + + + + + + + + + + + + + + + + + + + + +
+ # + # # + # # + # + # + # # + # # + # + # + # # + # # + # + # + # #
+ + + + + + + + + + + + + + + + + + + + + + + + + + + + + + + + + + +
+ # # # # + # # # # + # # # # + # # # # + # # # # + # # # # + # # # #
+ + + + + + + + + + + + + + + + + + + + + + + + + + + + + + + + + + +
+ # + # # + # # + # + # + # # + # # + # + # + # # + # # + # + # + # #
+ + + + + + + + + + + + + + + + + + + + + + + + + + + + + + + + + + +
+ # # # # + # # # # + # # # # + # # # # + # # # # + # # # # + # # # #
+ + + + + + + + + + + + + + + + + + + + + + + + + + + + + + + + + + +
+ # + # # + # # + # + # + # # + # # + # + # + # # + # # + # + # + # #
+ + + + + + + + + + + + + + + + + + + + + + + + + + + + + + + + + + +
+ # # # # + # # # # + # # # # + # # # # + # # # # + # # # # + # # # #
+ + + + + + + + + + + + + + + + + + + + + + + + + + + + + + + + + + +
+ # + # # + # # + # + # + # # + # # + # + # + # # + # # + # + # + # #
+ + + + + + + + + + + + + + + + + + + + + + + + + + + + + + + + + + +
+ # # # # + # # # # + # # # # + # # # # + # # # # + # # # # + # # # #
+ + + + + + + + + + + + + + + + + + + + + + + + + + + + + + + + + + +
+ # + # # + # # + # + # + # # + # # + # + # + # # + # # + # + # + # #
+ + + + + + + + + + + + + + + + + + + + + + + + + + + + + + + + + + +