40,40
+ + + + + + + + + + + + + + + + + + + + + + + + + + + + + + + + + + + + + + + +
+ # + # # + # + + # + # # + # + # + # # + # # + # + # + # # + # # + # + # + # #
+ + + + + + + + + + + + + + + + + + + + + + + + + + + + + + + + + + + + + + + +
+ # # # # + # # # # + # # # # + # # # # + # # # # + # # # # + # # # # + # # # #
+ + + + + + + + + + + + + + + + + + + + + + + + + + + + + + + + + + + + + + + +
+ # + # # + # + + # + # # + # + # + # # + # # + # + # + # # + # # + # + # + # #
+ + + + + + + + + + + + + + + + + + + + + + + + + + + + + + + + + + + + + + + +
+ # # # # + # + + # + # # # # + # # # # + # # # # + # # # # + # # # # + # # # #
+ + + + + + + + + + + + + + + + + + + + + + + + + + + + + + + + + + + + + + + +
+ # + # # + # + + # + # # + # + # + # # + # # + # + # + # # + # # + # + # + # #
+ + + + + + + + + + + + + + + + + + + + + + + + + + + + + + + + + + + + + + + +
+ # # # # + # + + # + # # # # + # # # # + # # # # + # # # # + # # # # + # # # #
+ + + + + + + + + + + + + + + + + + + + + + + + + + + + + + + + + + + + + + + +
+ # + # # + # + + # + # # + # + # + # # + # # + # + # + # # + # # + # + # + # #
+ + + + + + + + + + + + + + + + + + + + + + + + + + + + + + + + + + + + + + + +
+ # # # # + # # # # + # # # # + # # # # + # # # # + # # # # + # # # # + # # # #
+ + + + + + + + + + + + + + + + + + + + + + + + + + + + + + + + + + + + + + + +
+ # + # # + # # # # + # # + # + # + # # + # # + # + # + # # + # # + # + # + # #
+ + + + + + + + + + + + + + + + + + + + + + + + + + + + + + + + + + + + + + + +
+ # # # # + # + + # + # # # # + # # # # + # # # # + # # # # + # # # # + # # # # 
+ + + + + + + + + + + + + + + + + + + + + + + + + + + + + + + + + + + + + + + +
+ # + # # + # + + # + # # + # + # + # # + # # + # + # + # # + # # + # + # + # #
+ + + + + + + + + + + + + + + + + + + + + + + + + + + + + + + + + + + + + + + +
+ # # # # + # + + # + # # # # + # # # # + # # # # + # # # # + # # # # + # # # #
+ + + + + + + + + + + + + + + + + + + + + + + + + + + + + + + + + + + + + + + +
+ # + # # + # + + # + # # + # + # + # # + # # + # + # + # # + # # + # + # + # #
+ + + + + + + + + + + + + + + + + + + + + + + + + + + + + + + + + + + + + + + +
+ # # # # + # + + # + # # # # + # # # # + # # # # + # # # # + # # # # + # # # #
+ + + + + + + + + + + + + + + + + + + + + + + + + + + + + + + + + + + + + + + +
+ # + # # + # # # # + # # + # + # + # # + # # + # + # + # # + # # + # + # + # #
+ + + + + + + + + + + + + + + + + + + + + + + + + + + + + + + + + + + + + + + +
+ # # # # + # # # # + # # # # + # # # # + # # # # + # # # # + # # # # + # # # #
+ + + + + + + + + + + + + + + + + + + + + + + + + + + + + + + + + + + + + + + +
+ # + # # + # + + # + # # + # + # + # # + # # + # + # + # # + # # + # + # + # #
+ + + + + + + + + + + + + + + + + + + + + + + + + + + + + + + + + + + + + + + +
+ # # # # + # + + # + # # # # + # # # # + # # # # + # # # # + # # # # + # # # #
+ + + + + + + + + + + + + + + + + + + + + + + + + + + + + + + + + + + + + + + +
+ # + # # + # + + # + # # + # + # + # # + # # + # + # + # # + # # + # + # + # #
+ + + + + + + + + + + + + + + + + + + + + + + + + + + + + + + + + + + + + + + +
+ # # # # + # + + # + # # # # + # # # # + # # # # + # # # # + # # # # + # # # #