25,20
# + # + # + # + # + # + # + # + # + # +
+ + + + + + + + + + + + + + + + + + + +
# + # # # + # # # + # # # + # # # + # #
+ + + + + + + + + + + + + + + + + + + +
# + # + # + # + # + # + # + # + # + # +
+ + + + + + + + + + + + + + + + + + + +
# + # # # + # # # + # # # + # # # + # #
+ + + + + + + + + + + + + + + + + + + +
# + # + # + # + # + # + # + # + # + # +
+ + + + + + + + + + + + + + + + + + + +
# + # # # + # # # + # # # + # # # + # #
+ + + + + + + + + + + + + + + + + + + +
# + # + # + # + # + # + # + # + # + # +
+ + + + + + + + + + + + + + + + + + + +
# + # # # + # # # + # # # + # # # + # #
+ + + + + + + + + + + + + + + + + + + +
# + # + # + # + # + # + # + # + # + # +
+ + + + + + + + + + + + + + + + + + + +
# + # # # + # # # + # # # + # # # + # #
+ + + + + + + + + + + + + + + + + + + +
# + # + # + # + # + # + # + # + # + # +
+ + + + + + + + + + + + + + + + + + + +
# + # # # + # # # + # # # + # # # + # #
+ + + + + + + + + + + + + + + + + + + +
# + # + # + # + # + # + # + # + # + # +