35,35
# + + + + + + + + + + + + + + + + + + + + + + + + + + + + + + + + + +
# + # # # # # # # # # # # # # # + + # # # # # # # # # # # # # # # + +
# + # # # # # # # # # # # # # # + + # # # # # # # # # # # # # # # + +
# + # # # # # # # # # # # # # # + + # # # # # # # # # # # # # # # + +
# + # # + + + + + + + + + + + + + + + + + + + + + + + + + + # # + + +
# + # # + + + + + + + + + + + + + + + + + + + + + + + + + + # # + + +
# + # # + # # # # # # # # # # # # # # # # # # # # # # # # + # # # # +
# + # # + # # # # # # # # # # # # # # # # # # # # # # # # + # # + + +
# + # # + # # + + + + + + + + + + + + + + + + + + + + # # + # # + # #
# + # # + # # + + + + + + + + + + + + + + + + + + + + # # + # # + + +
# + # # + # # + # # # # # # # # + + # # # # # # # # + # # + # # + # #
# + # # + # # + # # # # # # # # + + # # # # # # # # + # # + # # + + +
# + # # + # # + # # + + + + + + + + + + + + + + # # + # # + # # + + +
# + # # + # # + # # + # # # # # # # # # # # # + # # + # # + # # + # #
# + # # + # # + # # + # # # # # # # # # # # # + # # + # # + # # + + +
# + # # + # # + # # + # # # # # # # # # # # # + # # + # # + # # + # #
# + # # + # # + # # + # # # # # # # # # # # # + # # + # # + # # + + +
# + # # + # # + # # + # # + + + + + + + + # # + # # + # # + # # + + +
# + # # + # # + # # + # # # # # + + # # # # # + # # + # # + # # + # #
# + # # + # # + # # + + + + + + + + + + + + + + # # + # # + # # + + +
# + # # + # # + # # # # # # # # # # # # # # # # # # + # # + # # + + +
# + # # + # # + + + + + + + + + + + + + + + + + + + + # # + # # + # #
# + # # + # # # # # # # # # # # + + # # # # # # # # # # # + # # + + +
# + # # + + + + + + + + + + + + + + + + + + + + + + + + + + # # + + +
# + # # # # # # # # # # # # # # # # # # # # # # # # # # # # # # + + +
# + + + + + + + + + + + + + + + + + + + + + + + + + + + + + + + + + #
# + # # # # # # # # # # # # # # # # # # # # # # # # # # # # # # # + +
# + # # # # # # # # # # # # # # # # # # # # # # # # # # # # # # # + +
# + # + + + + + + + + + + + + + + + + + + + + + + + + + + + + + # + +
# + # # # # # # # + # # # # # # # # # # # # # # # # # # # # # # # + +
# + # + + + + + + + + + + + + + + + + + + + + + + + + + + + + + # + +
# + # # # # # # # # # # # # # # # # # # # # + # # # # # # # # # # + +
# + # + + + + + + + + + + + + + + + + + + + + + + + + + + + + + # + +
# + # # # # # # # # # # # # # # + # # # # # # # # # # # # # # # # + +
# + + + + + + + + + + + + + + + + + + + + + + + + + + + + + + + + + +