7,7
# + # + # + #
+ + + + + + +
# + # + # + #
# + + + + + +
+ + # + # # #
+ # # + + + +
+ + + + # # #