40,40
+ + + + + + + + + + + + + + + + + + + + + + + + + + + + + + + + + + + + + + + +
+ # # # # # # # # # # # # # # # # # # + + # # # # # # # # # # # # # # # # # # +
+ # + + + + + + + + + + + + + + + + + + + # + + + + + + + + + + + + + + + + + +
+ # # # # # # # # # # # + # # # # # # # + # # # # # # # # # # # + # # # # # # #
+ # + + + + + + + + + + + + + + + + + + + # + + + + + + + + + + + + + + + + + +
+ # # # # # # # # # # # # # # # # # # + + # # # # # # # # # # # # # # # # # # +
+ # + + + + + + + + + + + + + + + + + + + # + + + + + + + + + + + + + + + + + +
+ # + # # # # # # # # # # # # # # # # # + # + # # # # # # # # # # # # # # # # #
+ # + + + + + + + + + + + + + + + + + + + # + + + + + + + + + + + + + + + + + +
+ # # # # # # # # # # # # # # # # # # + + # # # # # # # # # # # # # # # # # # +
+ # + + + + + + + + + + + + + + + + + + + # + + + + + + + + + + + + + + + + + +
+ # + # # # # # # # # # # # # # # # # # + # + # # # # # # # # # # # # # # # # #
+ # + + + + + + + + + + + + + + + + + + + # + + + + + + + + + + + + + + + + + +
+ # + # # # # # # # # # # # # # # # # + + # + # # # # # # # # # # # # # # # # +
+ # + + + + + + + + + + + + + + + + + + + # + + + + + + + + + + + + + + + + + +
+ # # # # # # # # # # # # # # # # # # # + # # # # # # # # # # # # # # # # # # #
+ + + + + + + + + + + + + + + + + + + + + + + + + + + + + + + + + + + + + + + +
# # # # # # # # # # # # # # # # # # # + # # # # # # # # # # # # # # # # # # # +
+ + + + + + + + + + + + + + + + + + + + + + + + + + + + + + + + + + + + + + + +
+ # # # # # # # # # # # # # # # # # # + + # # # # # # # # # # # # # # # # # # +
+ # + + + + + + + + + + + + + + + + + + + # + + + + + + + + + + + + + + + + + +
+ # # # # # # # # # # # + # # # # # # # + # # # # # # # # # # # + # # # # # # #
+ # + + + + + + + + + + + + + + + + + + + # + + + + + + + + + + + + + + + + + +
+ # # # # # # # # # # # # # # # # # # + + # # # # # # # # # # # # # # # # # # +
+ # + + + + + + + + + + + + + + + + + + + # + + + + + + + + + + + + + + + + + +
+ # + # # # # # # # # # # # # # # # # # + # + # # # # # # # # # # # # # # # # #
+ # + + + + + + + + + + + + + + + + + + + # + + + + + + + + + + + + + + + + + +
+ # # # # # # # # # # # # # # # # # # + + # # # # # # # # # # # # # # # # # # +
+ # + + + + + + + + + + + + + + + + + + + # + + + + + + + + + + + + + + + + + +
+ # + # # # # # # # # # # # # # # # # # + # + # # # # # # # # # # # # # # # # #
+ # + + + + + + + + + + + + + + + + + + + # + + + + + + + + + + + + + + + + + +
+ # + # # # # # # # # # # # # # # # # + + # + # # # # # # # # # # # # # # # # +
+ # + + + + + + + + + + + + + + + + + + + # + + + + + + + + + + + + + + + + + +
+ # # # # # # # # # # # # # # # # # # # + # # # # # # # # # # # # # # # # # # # 
+ + + + + + + + + + + + + + + + + + + + + + + + + + + + + + + + + + + + + + + +
# # # # # # # # # # # # # # # # # # # + # # # # # # # # # # # # # # # # # # # +
+ + + + + + + + + + + + + + + + + + + + + + + + + + + + + + + + + + + + + + + +
# # # # # # # # # # # # # # # # # # # + # # # # # # # # # # # # # # # # # # # +
+ + + + + + + + + + + + + + + + + + + + + + + + + + + + + + + + + + + + + + + +
# # # # # # # # # # # # # # # # # # # + # # # # # # # # # # # # # # # # # # # +