18,20
+ + + + + + + + + + + + + + + + + + + +
+ # # # # # # # # # # # # # # # # # # +
+ # + + + + + + + + + + + + + + + + + +
+ # # # # # # # # # # # + # # # # # # #
+ # + + + + + + + + + + + + + + + + + +
+ # # # # # # # # # # # # # # # # # # +
+ # + + + + + + + + + + + + + + + + + +
+ # + # # # # # # # # # # # # # # # # #
+ # + + + + + + + + + + + + + + + + + +
+ # # # # # # # # # # # # # # # # # # +
+ # + + + + + + + + + + + + + + + + + +
+ # + # # # # # # # # # # # # # # # # #
+ # + + + + + + + + + + + + + + + + + +
+ # + # # # # # # # # # # # # # # # # +
+ # + + + + + + + + + + + + + + + + + +
+ # # # # # # # # # # # # # # # # # # #
+ + + + + + + + + + + + + + + + + + + +
# # # # # # # # # # # # # # # # # # # +