15,15
# + # + # + # + # + # + # + #
+ + + + + + + + + + + + + + +
# # # + # # # # # # # + # # #
+ + + + + + + + + + + + + + +
# + # # # + # + # + # # # + #
+ + + + + + + + + + + + + + +
# + # + # + # # # + # + # + #
+ + + + + + + + + + + + + + +
# # # + # # # + # # # + # # #
+ + + + + + + + + + + + + + +
# + # # # + # + # + # # # + #
+ + + + + + + + + + + + + + +
# + # + # + # # # + # + # + #
+ + + + + + + + + + + + + + +
# # # # # # # + # # # # # # #