10,10
# + # + # + # + # +
+ + + + + + + + + +
# + # # # + # # # +
+ + + + + + + + + +
# # # + # # # + # #
+ + + + + + + + + +
# + # + # + # + # +
+ + + + + + + + + +
# + # # # # # + # #
+ + + + + + + + + +