18,20
# + # + # + # + # + # + # + # + # + # +
+ + + + + + + + + + + + + + + + + + + +
# # # # # + # # # # # # # # # + # # # #
+ + + + + + + + + + + + + + + + + + + +
# + # + # # # + # + # + # # # + # + # +
+ + + + + + + + + + + + + + + + + + + +
# + # + # + # + # # # # # + # + # + # +
+ + + + + + + + + + + + + + + + + + + +
# # # + # # # + # + # + # + # # # + # #
+ + + + + + + + + + + + + + + + + + + +
# + # + # + # + # # # + # + # + # + # +
+ + + + + + + + + + + + + + + + + + + +
# + # # # # # + # + # + # + # # # # # +
+ + + + + + + + + + + + + + + + + + + +
# # # + # + # + # # # + # + # + # + # #
+ + + + + + + + + + + + + + + + + + + +
# + # + # + # + # + # + # + # + # + # +
+ + + + + + + + + + + + + + + + + + + +