50,50
+ + + + + + + + + + + + + + + + + + + + + + + + + + + + + + + + + + + + + + + + + # + # # + # # + #
+ # + # # + # + + # + # # + # + # + # # + # # + # + # + # # + # # + # + # + # # + # + # # + # # + #
+ + + + + + + + + + + + + + + + + + + + + + + + + + + + + + + + + + + + + + + + + + + + + + # + + +
+ # # # # + # # # # + # # # # + # # # # + # # # # + # # # # + # # # # + # # # # + # + # # + # # + #
+ + + + + + + + + + + + + + + + + + + + + + + + + + + + + + + + + + + + + + + + + # + # # + # # + #
+ + + + + + + + + + + + + + + + + + + + + + + + + + + + + + + + + + + + + + + + + # + # # + # # + #
+ # + # # + # + + # + # # + # + # + # # + # # + # + # + # # + # # + # + # + # # + # + # # + # # + #
+ + + + + + + + + + + + + + + + + + + + + + + + + + + + + + + + + + + + + + + + + # + + # + + + + +
+ # # # # + # # # # + # # # # + # # # # + # # # # + # # # # + # # # # + # # # # + # + # # + # # + #
+ + + + + + + + + + + + + + + + + + + + + + + + + + + + + + + + + + + + + + + + + # + # # + # # + #
+ # + # # + # + + # + # # + # + # + # # + # # + # + # + # # + # # + # + # + # # + # + # # + # # + #
+ + + + + + + + + + + + + + + + + + + + + + + + + + + + + + + + + + + + + + + + + + + + + + # + + +
+ # # # # + # # # # + # # # # + # # # # + # # # # + # # # # + # # # # + # # # # + # + # # + # # + #
+ + + + + + + + + + + + + + + + + + + + + + + + + + + + + + + + + + + + + + + + + # + # # + # # + #
+ + + + + + + + + + + + + + + + + + + + + + + + + + + + + + + + + + + + + + + + + # + # # + # # + #
+ # + # # + # + + # + # # + # + # + # # + # # + # + # + # # + # # + # + # + # # + # + # # + # # + #
+ + + + + + + + + + + + + + + + + + + + + + + + + + + + + + + + + + + + + + + + + # + + # + + + + +
+ # # # # + # # # # + # # # # + # # # # + # # # # + # # # # + # # # # + # # # # + # + # # + # # + #
+ + + + + + + + + + + + + + + + + + + + + + + + + + + + + + + + + + + + + + + + + # + # # + # # + #
+ # + # # + # + + # + # # + # + # + # # + # # + # + # + # # + # # + # + # + # # + # + # # + # # + #
+ + + + + + + + + + + + + + + + + + + + + + + + + + + + + + + + + + + + + + + + + + + + + + # + + +
+ # # # # + # # # # + # # # # + # # # # + # # # # + # # # # + # # # # + # # # # + # + # # + # # + #
+ + + + + + + + + + + + + + + + + + + + + + + + + + + + + + + + + + + + + + + + + # + # # + # # + #
+ + + + + + + + + + + + + + + + + + + + + + + + + + + + + + + + + + + + + + + + + # + # # + # # + #
+ # + # # + # + + # + # # + # + # + # # + # # + # + # + # # + # # + # + # + # # + # + # # + # # + #
+ + + + + + + + + + + + + + + + + + + + + + + + + + + + + + + + + + + + + + + + + # + + # + + + + +
+ # # # # + # # # # + # # # # + # # # # + # # # # + # # # # + # # # # + # # # # + # + # # + # # + #
+ + + + + + + + + + + + + + + + + + + + + + + + + + + + + + + + + + + + + + + + + # + # # + # # + #
+ # + # # + # + + # + # # + # + # + # # + # # + # + # + # # + # # + # + # + # # + # + # # + # # + #
+ + + + + + + + + + + + + + + + + + + + + + + + + + + + + + + + + + + + + + + + + + + + + + # + + +
+ # # # # + # # # # + # # # # + # # # # + # # # # + # # # # + # # # # + # # # # + # + # # + # # + #
+ + + + + + + + + + + + + + + + + + + + + + + + + + + + + + + + + + + + + + + + + # + # # + # # + #
+ + + + + + + + + + + + + + + + + + + + + + + + + + + + + + + + + + + + + + + + + # + # # + # # + #
+ # + # # + # + + # + # # + # + # + # # + # # + # + # + # # + # # + # + # + # # + # + # # + # # + #
+ + + + + + + + + + + + + + + + + + + + + + + + + + + + + + + + + + + + + + + + + # + + # + + + + +
+ # # # # + # # # # + # # # # + # # # # + # # # # + # # # # + # # # # + # # # # + # + # # + # # + #
+ + + + + + + + + + + + + + + + + + + + + + + + + + + + + + + + + + + + + + + + + # + # # + # # + #
+ # + # # + # + + # + # # + # + # + # # + # # + # + # + # # + # # + # + # + # # + # + # # + # # + #
+ + + + + + + + + + + + + + + + + + + + + + + + + + + + + + + + + + + + + + + + + + + + + + # + + +
+ # # # # + # # # # + # # # # + # # # # + # # # # + # # # # + # # # # + # # # # + # + # # + # # + #
+ + + + + + + + + + + + + + + + + + + + + + + + + + + + + + + + + + + + + + + + + # + # # + # # + #
+ + + + + + + + + + + + + + + + + + + + + + + + + + + + + + + + + + + + + + + + + # + # # + # # + #
+ # + # # + # + + # + # # + # + # + # # + # # + # + # + # # + # # + # + # + # # + # + # # + # # + #
+ + + + + + + + + + + + + + + + + + + + + + + + + + + + + + + + + + + + + + + + + # + + # + + + + +
+ # # # # + # # # # + # # # # + # # # # + # # # # + # # # # + # # # # + # # # # + # + # # + # # + #
+ + + + + + + + + + + + + + + + + + + + + + + + + + + + + + + + + + + + + + + + + # + # # + # # + #
+ # + # # + # + + # + # # + # + # + # # + # # + # + # + # # + # # + # + # + # # + # + # # + # # + #
+ + + + + + + + + + + + + + + + + + + + + + + + + + + + + + + + + + + + + + + + + + + + + + # + + +
+ # # # # + # # # # + # # # # + # # # # + # # # # + # # # # + # # # # + # # # # + # + # # + # # + #
+ + + + + + + + + + + + + + + + + + + + + + + + + + + + + + + + + + + + + + + + + # + # # + # # + #