7,7
+ + + + + + +
+ # # # # # +
+ # + + + + +
+ # # # # # #
+ # + + + + +
+ # # # # # +
+ + + + + + +