25,35
# + # + # + # + # + # + # + # + # + # + # + # + # + # + # + # + # + #
+ + + + + + + + + + + + + + + + + + + + + + + + + + + + + + + + + + +
# + # # + # # + # # + # # + # # + # # + # # + # # + # # + # # + # # #
+ + + + + + + + + + + + + + + + + + + + + + + + + + + + + + + + + + +
# + # + # + # + # + # + # + # + # + # + # + # + # + # + # + # + # + #
+ + + + + + + + + + + + + + + + + + + + + + + + + + + + + + + + + + +
# + # # + # # + # # + # # + # # + # # + # # + # # + # # + # # + # # #
+ + + + + + + + + + + + + + + + + + + + + + + + + + + + + + + + + + +
# + # + # + # + # + # + # + # + # + # + # + # + # + # + # + # + # + #
+ + + + + + + + + + + + + + + + + + + + + + + + + + + + + + + + + + +
# + # # + # # + # # + # # + # # + # # + # # + # # + # # + # # + # # #
+ + + + + + + + + + + + + + + + + + + + + + + + + + + + + + + + + + +
# + # + # + # + # + # + # + # + # + # + # + # + # + # + # + # + # + #
+ + + + + + + + + + + + + + + + + + + + + + + + + + + + + + + + + + +
# + # # + # # + # # + # # + # # + # # + # # + # # + # # + # # + # # #
+ + + + + + + + + + + + + + + + + + + + + + + + + + + + + + + + + + +
# + # + # + # + # + # + # + # + # + # + # + # + # + # + # + # + # + #
+ + + + + + + + + + + + + + + + + + + + + + + + + + + + + + + + + + +
# + # # + # # + # # + # # + # # + # # + # # + # # + # # + # # + # # #
+ + + + + + + + + + + + + + + + + + + + + + + + + + + + + + + + + + +
# + # + # + # + # + # + # + # + # + # + # + # + # + # + # + # + # + #
+ + + + + + + + + + + + + + + + + + + + + + + + + + + + + + + + + + +
# + # # + # # + # # + # # + # # + # # + # # + # # + # # + # # + # # #
+ + + + + + + + + + + + + + + + + + + + + + + + + + + + + + + + + + +
# + # + # + # + # + # + # + # + # + # + # + # + # + # + # + # + # + #