25,35
+ + + + + + + + + + + + + + + + + ~ ~ ~ ~ ~ + + + + + + + + + + + + +
# # # # # # # + + + # # # # # + + ~ ~ ~ ~ ~ + # # # # # # # # # # + +
# + + + + + + + + + + + + + + + + + + + + + + + + + + + + + + + + + +
# + # # # # # # # # # # # # - # # # # + # # # - # # # # # # # # + + +
# + # + + + + + + + + + + + + + + + # + + + + + + + + + + + + + + + +
# + # + # # # # + # # # # # # # # # # + # # # # # # # # # # # # # + +
# + + + # + + + + + + # + + + + + + + + + + + + + + # + + + + + + + +
# + # # + # # # # + # + # # # # # # # # # # # + # # # + # # # # # + +
# + # + + + + + + + + + + + + + + + + + + + + + # + + + + + + + + + +
# + # # # # # # # # # # # # # # # # + # # # + + # # + # # # # + + + +
# + + + + + + + + + + + # + + + + + + + + + + + + + + + # + + + + + +
# # # # # # # # # # - # # # # # # # # # # # # # # # - # # # # # + + +
# + + + + + + + + + + + + + + + + + + + + + + + # + + + + + + + + + +
# + # # # # # # # # # # # # # # # + # # # + + + # # # # # # # # + + +
# + + + + + + + + # + + + + + + + + # + + + + + + + + + + + + + + + +
# # # # # # # + # + # # # # # # + # # + # # # # # # # + # # # # # + +
# + + + + + + + # + + + + + + + + + + + # + + + + + + + + + + + + + +
# + # # # - # # # # # # # # # # # + # + # + # # # # # # # + # # # + +
# + # + + + + + + + + + + + + + + + + + # + + + + + + + + + + # + + +
# + # # # # # # + # # # # + # # # # # # # # + # # # # + # # # # + + +
# + + + + + # + + + + + + + + + + + + + + + + + + + + + + + + + + + +
# # # + # + # # # # # # # # # # # # + # # # # # # # # + # # # # + # +
# + + + + + # + + + + + + + + + + + + + + + + + + + + + + + + + + + +
# + # # # # # # # - # # + # # # # # # + # # # # # # # # # # + # # + +
+ + + + + + + + + + + + + + + + + + + + + + + + + + + + + + + + + + +