25,35
# # # # # + + + + + + + + + # # # # # + + + + + + + + + + + + + + + +
# + + + + + # # # # # + + + # + + + + + + + + + + + + + + + + + + # +
# + # # # + + + + + # + + + # + # # # # # # # # # # # # # + + # + # +
# + # + + + # # # + # + # + # + + + + + + + + + + + + + + + + # + + +
# + + + # + + + # + + + # + + # # # # # # + # # # # # + + # + # # # +
# # # + # # # + # # # + # # # # + + + + + # + + + + + + + # + + + + +
# + + + + + + + + + + + + + + + + # # + # + # # # # # # # # # # # + +
# + # # # # # # # # # # # # # + # + + # + + + + + + + + + + + + + + +
# + + + + + + + + + + + + + + + + + + # + # # # + # # # # # + # # # +
# # # # # # # # + # # # # # # # # + + # + # + + + + + + + + # + + + +
# + + + + + + + + + + + + + + + + # + # + # # # # # # # # + + + # # +
# + # # # # + # # # # # # # # # # # + # + # + + + + + + + + # + + + +
# + # + + + + + + + + + + + + + + + + # + # + # # # # # # # + # # # +
# + # + # # # # # # # # # # # # + # # # + # + + + + + + + + + + + + +
# + # + + + + + + + + + + + + + + + + + + + # # # # + # # # # # # # +
# + # # # # # # # # # # # # # # # # # # + + + + + + + + + + + + + + +
# + + + + + + + + + + + + + + + + + + + + + # # # # # + # # # + + # #
# + # # # # # # # # # # # # # # + # # + + + + + + # + # + + + + + # +
# + + + + + + + + + + + + + + + + + + # # # # + # + + + # # # # # # +
# # # # # # # # # # # # # # # # # # + + + + + # + + + + + + + + + + +
# + + + + + + + + + + + + + + + + + + # # # # # + # # + # # # # + # +
# + # # # # # # # + # # # # # # # # + + + + + + + + + + + + + + + # +
# + + + + + + + + + + + + + + + + + # # # # + # # # # # # # + # # # +
# # # # # # + + + # # # # # # # # + + + + + + + + + + + + + + + + + +
+ + + + + + + + + + + + + + + + + + + + + + + + + + + + + + + + + + +