25,35
+ + + + + + + + + + - - - + + + + + + + + + + + + + + + + + + + + + +
# # # # ~ # # # # + # # # + # # # # + # ~ ~ # # # + # # # # # # # + +
# + + + ~ + + + + + + - - + + + + + + + + + + + + + + - - + + + + + +
# + # # ~ # # # # # # # # + # # # # + + # # # # # # + # # # # + # + +
# + # + + + - - - + + ~ + + + - - - + + + + + + + + + + + + + + + + +
# + # + # # # ~ + # # # # # # # # # # + # # # ~ ~ ~ # # # # # # # + +
# + + + # + + + + + + # + + + + + + + + + + + + + + # + + + + + + + +
# # # + # + # # # # + # + # # # # # # # # # # + # + # + # # # # # + +
# + + + + + # + + + + + + + + ~ + + + + + + + + # + + + + + + # + + +
# + # # # + # # # # # # # + # # # # # + # # # - + # # + # # # # + ~ +
# + + + + + + + - - - + + + + + + + - - - - - - + + + # + + + + + + +
# # # # # # # ~ # # + # # # # # # # # # # # # # # # + # # # # # + + +
# + + + + + + + + + + + + + + ~ + + + + + + + + # + + + + + + + + + +
# + # # # # # # # # # # + # # # # + # # # + + + # # # # # # # # + + +
# + + + + + + + + # + - - - - + + # + + + + - - + + + + + + + + + + +
# # # # # # + + # + # # # # # # + # # + # # # # # # # + # # # # # + +
# + + + + + + - + # + - - - - + + + + # + + + + + + + + + + + + + + +
# + # # # + # # # # # # # # # # # + # + # + # # # # # # # + # # # + +
# + # + + + + + + + + + + + + + + + + + # + + + + + + + + + + # + + +
# + # # # # # # + # # # # + # # # # # # # # + # # # # + # # # # + + +
# + + + + + # + + + + + + + + + + + + + ~ + + + + + + + + + + + + + +
# # # + # + # # # # # # # # # # # # + # # # # # # # # + # # # # + # +
# + + + + + # + + + + + + + + + + + + + + + + + + + + + + + + + + + +
# + # # # # # # # + # # + # # # # # # + # # # # # # # # # # + # # + +
+ + + + + + + + + + + + + + + + + + + + + + + + + + + + + + + + + + +