25,35
+ + + + + + + + + - - + + + + + + + + - - ~ + + + + + + + + + + + + +
# # # # # # + # + # # + # # # # # + + ~ ~ ~ + # # # # # # # # + + + +
# + + + + + + + + + + + + + - - - + + + + + + + + + + - - - - + + + +
# + # # # # # # # # # # # + # # # + # # # # # # # # + # # # # + + + +
# + # + + + + + + + + ~ + + + + + + + + - + + + + + + + + + + + + + +
# + # + # # # # + # # # # # # # # # # + # # # # # # ~ # # # # # # # +
# + + + # + + + ~ ~ + + + + + + + + + - - - - - + + # + + + + + + + +
# # # + # + # # # # + # + # # # # # # # # # # + # + # + # # # # # + +
# + + - + + # + + + + + + ~ ~ + + + + + + + + + # + + + + + + # + + +
# + # # # + # # # # # # # + # # # # # + # # # - + # # + # # # # + + +
# + + + + + + + + + + + # + + + + + + - - - - - - + + + # + + + + + +
# # # # # # # # # # + # # # # # # # # # # # # # # # # + # # # # # + +
# + + + + + + + + + + + + + + + + + + + + + + + # + + + + + + + + + +
# + # # # # # # # # # # + # # # # + # # # + + + # # # # # # # # + # +
# + + + + + + - - - - - + + + + + + # + + + + + + + + + ~ ~ + + + + +
# # # # # # + # + # # # # # # + # # + # # # # # # # + # # # # # + + +
# + + + + + + + # + + + + + + + + + + + # + + + + - - + + + + + + + +
# + # # # + # # # # # # # # # # # + # + # + # # # # # # # + # # # + +
# + # + + + + + + + + + + + + + + + + + # + + + + + + + + + + # + + +
# + # # # # # # + # # # # + # # # # # # # # + # # # # + # # # # + + +
# + + + + + # + + + + + + + + + + + + + + + + + + + + + + + ~ + + + +
# # # + # + # # # # # # # # # # # # + # # # # # # # # + # # # # + # +
# + + + + + # + + + + + + + + + + + + + + + + + + + + + + + + + + + +
# + # # # # # # # + # # + # # # # # # + # # # # # # # # # # + # # + +
+ + + + + + + + + + + + + + + + + + + + + + + + + + + + + + + + + + +