25,35
+ + + + + + + + + + # # # # # # # + + + + + + + + + + + + + + + + + +
# # # # # # # + + + # # # # # # # - # # # # + # # # # # # + # # # - -
# + + + + + + + + + + + + + + + + + # + + + + + + + + + + + + + + + +
# + # # # # # # # # + # # # # # + + # + # # # # # # # # # # # # + + +
# + # + + + + + + + + + + + # + + + + + # + + + + + + + + + + # + + +
# + # + # # # # + # # # # + # # # # # + # + # # # # # # # # + # # # +
# + + + # + + + + + + # + + + + + + + + + + + + + + + + # + + + + + +
# # # + # + # # # # + # + # # # # # # # # # # # + # # + # # # # # + +
# + + + + + # + + + + + + + + + + + + + + + + + + # + + + + + + # + +
# + # # # + # # # - - - - - - - - - # + # # # + + # # + # # # # + + +
# + + + + + + + + - - ~ ~ ~ ~ ~ ~ - + + + + + + + + + + # + + + + + +
# # # # # # # # + - - ~ ~ ~ ~ ~ ~ # # # # # # # # # # + # # # # # + +
# + + + + + + + + - - - - - - - - - + + + + + + # + + + + + + + + + +
# + # # # # # # # # # # + # # # # + # # # + + + # # # # # # # # # + +
# + + + + + + + + # + + + + + + + + # + + + + + + + + + + + + + + + +
# # # # # # # + # + # # # # # # + # # + # # # # # # # - # # # # # # +
# + + + + + + + # + + + + + + + + + + + # + + + + + + + + + + + + + +
# + # # # + # # # # # # # # # # # + # - # + # # # # # # # + # # # + +
# + # + + + + + + + + + + + + + + + + + # + + + + + + + + + + # + + +
# + # # # # # # + # # # # - # # # # # # # # + # # # # + # # # # + + +
# + + + + + # + + + + + + + + + + + + + + + + + + + + + + + + + + + +
# # # + # + # # # # # # # # # # # # + # # # # # # # # + # # # # + # +
# + + + + + # + + + + + + + + + + + + + + + + + + + + + + + + + + + +
# + # # # # # # # + # # + # # # # # # + # # # # # # # # # # + # # + +
+ + + + + + + + + + + + + + + + + + + + + + + + + + + + + + + + + + +