25,35
+ + + + + + + + + + + + + + + + + + + + ~ ~ + + + + + + + + + + + + +
# # # # # # # # + # # + # # # # + + + + ~ ~ + # # # # # # # # # + + +
# + + + + + + + + + + + + + + + + + + + + + + + + + - - - - + + + + +
# + # # # # # # # # # # # # # # + # # # # + # # # # # # # # + + # + +
# + # + + + + ~ ~ + + + + + + + + + + + + + + + + + + ~ + + + + + + +
# + # + # # # ~ ~ # # # # # # # # + # # # # # # # # + + # # # # # + +
# + + + # + + + + + + # + + + + + + + - - + + + + + # + + + + + + + +
# # # + # + # # # # + # + # # # # # # # # # # + # + # + # # # # # + +
# + + + + + # + + + + + + + + ~ + + + + + + + + # + + + + + + + + + +
# + # # # + # # # # # # # + # # # # # + # # # + + # # + # # # # + + +
# + + + + + + + + + + + + + + + + + + + + + + + + + ~ + + + + + + + +
# # # # # # # # # # + # # # # # # # # # # # # # # # + # # # # # + + +
# + + + + + + + + + + + + + + + + + + + + + + + # + + + + + + + + + +
# + # # # # # # # # # # # # # # + # # # + + + # # # # # # # # + ~ + +
# + + + + + + + + # + + + + + + + # + + + + + + + + + ~ ~ + + + + + +
# # # # # # + + # + # # # # # # # # + # # # # # # # + # # # # # + + +
# + + + + + + + # + + + + + + + + + + + # + + + + + + - - + + + + + +
# + # # # + # # # # # # # # # # # + # + # + # # # # # # # + # # # + +
# + # + + + + + + + + + + + + + + + + + # + + + + + + + + + + # + + +
# + # # # # # # + # # # # + # # # # # # # # + # # # # + # # # # + + +
# + + ~ + + # + + + + + + + + + + + + + + + + + + + + + + + + + + + +
# # # + # + # # # # # # # # # # # # + # # # # # # # # + # # # # + # +
# + + + + + # + + + + + + + + + + + + + + + + + + + + + + + + + + + +
# + # # # # # # # + # # + # # # # # # + # # # # # # # # # # + # # + +
+ + + + + + + + + + + + + + + + + + + + + + + + + + + + + + + + + + +