25,35
# # # # # # # # # # # # # # + + # # # # # + # # # # # # # # # # # # #
# + + + + + + + + + + + + + + + # # # # # + + + + + + + + + + + + + +
# + # # # + # # # + # # # # + + # # # # # + # # # # # # # # # # # # #
# + # # # + # # # + # # # # + + + # # + + + + + + + + + + + + + + + #
# + # # # + # # # + # # # # # + + + + + + # # # # # # # + # # # # + #
# + + + + + + + + + # # # # # # # + + # # # # # + + + # + # # # # + #
# # # # + # # # # + # # # + + + + + + + + + + # + # + # + + + # # + #
# + # # + # # # # + # # # - - - - - - - - - - # + # + # + # # # # + #
# + # # + # # # # + # # # - - - - - - - - - - # + # + # + + + + + + #
# + # # # # # # # + # # # - - - - - - - - - + + + # + # + # # # # + #
# + # # # # # # # + # # # - - - - - - - - - + # # # + # + # # # # + #
# + + + + + + + + + + + + + + + + + + + + + + # # # + + + # # # # + #
# # # # # + # # # # # # # # # # # + + # # # # # # # + # # # # # # + #
# + - - # + # # # # # # # # # # # + + # # # + + + + + # # ~ ~ ~ # + #
# + - - # + + + + + + + + + # # # + + # # # # # # # # # # ~ ~ ~ # + #
# + # # # + - - ~ ~ ~ ~ ~ ~ ~ ~ ~ + + ~ ~ ~ ~ ~ ~ ~ ~ ~ ~ ~ ~ ~ # + #
# + # # # + - - ~ ~ ~ ~ ~ ~ ~ ~ ~ + + ~ ~ ~ ~ ~ ~ ~ ~ ~ ~ ~ ~ ~ + + #
# + # # # + + + + + + + + + + # # + + # # # # # # # # # # ~ ~ ~ + # #
# + # # # + # # # # # # # # + # # + + # # + + + + + + + + ~ ~ ~ + # #
# + + + + + # # # # # # # # + # # + + # # + - - - - - - + ~ ~ ~ + # #
# + # # # + + + # # # # # # + # # + + + + + + + + + + + + - - - + # #
# + # # # + # + # # # # # # + # # + + # # + - - + - - + + + + + + + #
# + # # # + # + + + + + + + + + + + + # # + - - + - - + - - - - - + #
# + + + + + # # # # # # # # # # # + + # # + + + + + + + + + + + + + #