25,35
+ + + + + + + + + + + + + + + ~ ~ ~ ~ + + + + + + + + + + + + + + + +
# # # # # + + + + # # + # # # ~ ~ ~ ~ + # # # # # + # # # # # + + + +
# + + + + + - - - + + + + + + + + ~ + + + + + - - - - + + + + + + + +
# + # # # # # # # # # # # # + + + ~ + + # # # # # # # # + # # + # + +
# + # + + + + + + + + + + + + + + + + + + + + + + ~ + + + + + + + + +
# + # + # # # + # # # # # # # # # # + + # # # ~ ~ ~ # # # # # # # + +
# + + + # + + + + + + # + + + + + + + + + + + + + + # + + + - - + + +
# # # + # + # # # # + # + # # # # # # # # # # + ~ + # + # # # # # + +
# + + + + + # + + + + + + ~ + + + + + + + + + + # + + + + + + # + + +
# + # # # + # # # # # # # + # # # # # + # # # + + # # + # # # # + + +
# + + + + + + + + + + + # + + + + + + + ~ + + + + + + # + + + + + + +
# # # # # # # # # # + # # # # # # # # # # ~ # # # # + # # # # # + + +
# + + + + + + + + + + + + + + + + + + + + + + + # + + + + + + + + + +
# + # # # # # # # # # # # # # # # + # # # + + + # # # # # # # # + + +
# + + + + + + + + # + + + + + + + + # + + + + + + + + + + + + + + + +
# # # # # # + + # + # # # # # # + # # + # # # # # # # + # # # # # + +
# + + + + + + + # + + + + + + + + + + + # + + + + + + - - + + + + + +
# + # # # + # # # # # # # # # # # + # + # + # # # # # # # + # # # + +
# + # + + + + - - - - - - - - - - - + + # + + + + + + + + + + # + + +
# + # # # # # # + # # # # + # # # # # # # # + # # # # + # # # # + + +
# + + + + + # + + + + + + + + + + + + + ~ + + + + + + + + + + + + + +
# # # + # + # # # # # # # # # # # # + # # # # # # # # + # # # # + # +
# + + + + + # + + + + + + + + + + + + + + + + + + + + + + + + + + + +
# + # # # # # # # + # # + # # # # # # + # # # # # # # # # # + # # + +
+ + + + + + + + + + + + + + + + + + + + + + + + + + + + + + + + + + +